╋╋╋╋╋╋╋╋╋╋╋╋╋╋╋╋╋╋╋╋╋╋╋╋╋╋╋╋╋╋╋╋╋╋╋╋╋╋╋╋╋╋╋╋╋╋╋╋                                                                                                        ╋╋╋╋╋╋╋╋╋╋╋╋╋╋╋╋╋╋╋╋╋╋╋╋╋╋╋                     
╋                                           ╋╋╋╋                                                                                                        ╋╋╋                      ╋╋╋                    
╋                                           ╋╋╋╋                                                                                                        ╋╋╋                      ╋╋╋                    
╋                                           ╋╋╋╋╋╋╋╋╋╋╋╋╋╋╋╋╋╋╋╋╋╋╋╋╋╋╋╋╋╋╋╋╋╋╋╋╋╋╋╋╋                                                                   ╋╋╋                      ╋╋╋                    
╋                                           ╋╋╋╋╋╋╋╋╋╋╋╋╋╋╋╋╋╋╋╋╋╋╋╋╋╋╋╋╋╋╋╋╋╋╋╋╋╋╋╋╋╋                                                                   ╋╋╋                    ╋╋╋                     
╋                                            ╋╋╋╋╋╋╋╋╋╋╋╋╋╋╋╋╋╋╋╋╋╋╋╋╋╋╋╋╋╋╋╋╋╋╋╋╋╋╋╋╋╋                                                                  ╋╋╋                    ╋╋╋                     
╋                                            ╋╋╋╋╋╋╋╋╋╋╋╋╋╋╋╋╋╋╋╋╋╋╋╋╋╋╋╋╋╋╋╋╋╋╋╋╋╋╋╋╋╋╋╋╋╋╋╋╋╋╋                                                         ╋╋╋                    ╋╋╋                     
╋                                                                                   ╋╋╋╋╋╋╋╋╋╋╋╋╋╋                                                       ╋╋╋                    ╋╋╋                     
╋                                                                                   ╋╋╋╋╋╋╋╋╋╋╋╋╋╋╋╋╋                                                     ╋╋╋                   ╋╋╋                     
╋                                                                                   ╋╋╋╋╋╋╋╋╋╋╋╋╋╋╋╋╋╋╋                                                   ╋╋╋                   ╋╋╋                     
╋╋╋╋╋╋╋╋╋╋╋╋╋╋╋╋╋╋╋╋╋╋╋╋╋╋╋╋╋╋╋╋╋╋╋╋╋╋╋╋                                           ╋╋╋╋╋╋╋    ╋╋╋╋╋╋╋╋╋╋                                                  ╋╋╋                   ╋╋╋                     
╋╋╋╋╋╋╋╋╋╋╋╋╋╋╋╋╋╋╋╋╋╋╋╋╋╋╋╋╋╋╋╋╋╋╋╋╋╋╋╋╋                                           ╋              ╋╋╋╋╋╋╋                                                ╋╋╋                  ╋╋╋                      
╋╋╋╋╋╋╋╋╋╋╋╋╋╋╋╋╋╋╋╋╋╋╋╋╋╋╋╋╋╋╋╋╋╋╋╋╋╋╋╋╋                                                            ╋╋╋╋╋╋                                               ╋╋╋                  ╋╋╋                      
╋╋╋╋╋╋╋╋╋╋╋╋╋╋╋╋╋╋╋╋╋╋╋╋╋╋╋╋╋╋╋╋╋╋╋╋╋╋╋╋╋                                                              ╋╋╋╋╋                                               ╋╋╋                 ╋╋╋                      
                                     ╋╋╋╋                                   ╋                           ╋╋╋╋╋                                              ╋╋╋                 ╋╋╋                      
                                     ╋╋╋╋                                  ╋╋                            ╋╋╋╋╋                                             ╋╋╋                 ╋╋╋                      
                                     ╋╋╋╋╋╋╋╋╋╋╋╋╋╋╋╋╋╋╋╋╋╋╋╋╋╋╋╋╋╋╋╋╋╋╋╋╋╋╋╋                             ╋╋╋╋╋                                            ╋╋╋                 ╋╋╋                      
                                      ╋╋╋╋╋╋╋╋╋╋╋╋╋╋╋╋╋╋╋╋╋╋╋╋╋╋╋╋╋╋╋╋╋╋╋╋╋╋                               ╋╋╋╋╋                                            ╋╋╋               ╋╋╋                       
                                       ╋╋╋╋╋╋╋╋╋╋╋╋╋╋╋╋╋╋╋╋╋╋╋╋╋╋╋╋╋╋╋╋╋╋╋╋                                 ╋╋╋╋                                            ╋╋╋               ╋╋╋                       
                                        ╋╋╋╋╋╋╋╋╋╋╋╋╋╋╋╋╋╋╋╋╋╋╋╋╋╋╋╋╋╋╋╋╋╋                                   ╋╋╋╋                                           ╋╋╋               ╋╋╋                       
                                                                      ╋╋╋╋                                   ╋╋╋╋                                           ╋╋╋               ╋╋╋                       
                                                                     ╋╋╋╋                                     ╋╋╋╋                                           ╋╋╋              ╋╋╋                       
                                                                     ╋╋╋╋                                     ╋╋╋╋                                           ╋╋╋              ╋╋╋                       
                                                                     ╋╋╋                                       ╋╋╋╋                                          ╋╋╋              ╋╋╋                       
                                                                    ╋╋╋╋                                       ╋╋╋╋                                          ╋╋╋             ╋╋╋                        
                                                                    ╋╋╋╋                                       ╋╋╋╋                                          ╋╋╋             ╋╋╋                        
                                                                    ╋╋╋╋                                       ╋╋╋╋                                           ╋╋╋            ╋╋╋                        
                                                                    ╋╋╋                                         ╋╋╋                                           ╋╋╋            ╋╋╋                        
                                                                    ╋╋╋                                         ╋╋╋                                           ╋╋╋            ╋╋╋                        
                                                                    ╋╋╋                                         ╋╋╋                                           ╋╋╋            ╋╋╋                        
                                                                    ╋╋╋                                         ╋╋╋                                            ╋╋╋           ╋╋╋                        
                                                                    ╋╋╋╋                                       ╋╋╋╋                                            ╋╋╋          ╋╋╋                         
                                                                    ╋╋╋╋                                       ╋╋╋╋                                            ╋╋╋          ╋╋╋                         
                                                                    ╋╋╋╋                                       ╋╋╋╋                                            ╋╋╋          ╋╋╋                         
                                                                    ╋╋╋                                        ╋╋╋                                              ╋╋╋         ╋╋╋                         
                                                                    ╋╋╋╋                                      ╋╋╋╋                                              ╋╋╋         ╋╋╋                         
                                                                  ╋╋╋╋╋╋                                      ╋╋╋╋                                              ╋╋╋         ╋╋╋                         
                                                                ╋╋╋╋╋╋                                       ╋╋╋╋                                               ╋╋╋        ╋╋╋                          
                                                               ╋╋╋╋╋╋                                        ╋╋╋╋                                               ╋╋╋        ╋╋╋                          
                                                             ╋╋╋╋╋╋      ╋                                  ╋╋╋╋                                                 ╋╋╋       ╋╋╋                          
                                                           ╋╋╋╋╋╋╋    ╋╋╋╋╋╋                               ╋╋╋╋╋╋╋╋╋╋╋╋╋╋                                        ╋╋╋       ╋╋╋                          
                                                         ╋╋╋╋╋╋╋     ╋╋╋╋╋╋╋╋                           ╋ ╋╋╋╋╋╋╋╋╋╋╋╋╋╋╋╋                                       ╋╋╋       ╋╋╋                          
                                                        ╋╋╋╋╋╋      ╋╋╋╋╋╋╋╋╋╋                         ╋╋╋╋╋╋╋╋╋╋╋╋╋╋╋╋╋╋╋╋                                      ╋╋╋       ╋╋╋                          
                                                      ╋╋╋╋╋╋      ╋╋╋╋╋   ╋╋╋╋╋                         ╋╋╋╋╋╋╋╋╋╋╋╋╋╋╋╋╋╋╋╋                                      ╋╋╋      ╋╋╋                          
                                                    ╋╋╋╋╋╋      ╋╋╋╋╋╋     ╋╋╋╋╋                         ╋╋             ╋╋╋╋╋                                     ╋╋╋     ╋╋╋                           
                                                  ╋╋╋╋╋╋      ╋╋╋╋╋╋        ╋╋╋╋╋╋                 ╋      ╋              ╋╋╋╋                                     ╋╋╋     ╋╋╋                           
                                                 ╋╋╋╋╋      ╋╋╋╋╋╋           ╋╋╋╋╋╋╋              ╋╋╋                     ╋╋╋╋                                    ╋╋╋     ╋╋╋                           
                                               ╋╋╋╋╋      ╋╋╋╋╋╋               ╋╋╋╋╋╋╋╋╋╋    ╋╋╋╋╋╋                       ╋╋╋╋                                     ╋╋╋    ╋╋╋                           
                                             ╋╋╋╋╋      ╋╋╋╋╋╋                  ╋╋╋╋╋╋╋╋╋╋╋╋╋╋╋╋╋╋╋                        ╋╋╋╋                                    ╋╋╋    ╋╋╋                           
                                           ╋╋╋╋╋╋     ╋╋╋╋╋╋                      ╋╋╋╋╋╋╋╋╋╋╋╋╋╋╋╋                         ╋╋╋╋                                    ╋╋╋    ╋╋╋                           
                                          ╋╋╋╋╋     ╋╋╋╋╋╋                           ╋╋╋╋╋╋╋╋╋╋╋╋╋                          ╋╋╋╋                                 ╋╋╋╋     ╋╋╋╋                          
                                        ╋╋╋╋╋     ╋╋╋╋╋╋                                     ╋╋╋╋                           ╋╋╋╋╋                               ╋╋╋╋╋     ╋╋╋╋╋                         
                                      ╋╋╋╋╋     ╋╋╋╋╋╋                                      ╋╋╋╋                             ╋╋╋╋                               ╋╋╋         ╋╋╋                         
                                    ╋╋╋╋╋╋    ╋╋╋╋╋╋                            ╋╋╋         ╋╋╋╋                              ╋╋╋╋                             ╋╋╋           ╋╋╋                        
                                   ╋╋╋╋╋    ╋╋╋╋╋╋                             ╋╋╋╋╋       ╋╋╋╋                               ╋╋╋╋                             ╋╋            ╋╋╋                        
                                 ╋╋╋╋╋    ╋╋╋╋╋╋                              ╋╋╋╋╋╋╋╋    ╋╋╋╋                                 ╋╋╋╋                           ╋╋╋             ╋╋╋                       
                               ╋╋╋╋╋     ╋╋╋╋╋                               ╋╋╋╋  ╋╋╋╋╋  ╋╋╋╋                                 ╋╋╋╋                           ╋╋╋             ╋╋╋                       
                             ╋╋╋╋╋╋    ╋╋╋╋╋                                ╋╋╋     ╋╋╋╋╋╋╋╋╋                                   ╋╋╋╋                          ╋╋╋             ╋╋╋                       
                            ╋╋╋╋╋    ╋╋╋╋╋                                 ╋╋╋        ╋╋╋╋╋╋╋                                   ╋╋╋╋                          ╋╋╋             ╋╋╋                       
                          ╋╋╋╋╋    ╋╋╋╋╋╋                                ╋╋╋╋           ╋╋╋╋╋                                   ╋╋╋╋                          ╋╋╋             ╋╋╋                       
 ╋╋╋╋╋╋╋╋╋╋╋╋╋╋╋╋╋╋╋╋╋╋╋╋╋╋╋╋╋     ╋╋╋╋╋╋╋╋╋╋╋╋╋╋╋╋╋╋╋╋╋╋╋╋             ╋╋╋╋             ╋╋╋╋╋                                 ╋╋╋╋                           ╋╋╋             ╋╋╋                       
 ╋                         ╋        ╋                     ╋            ╋╋╋╋               ╋╋╋╋╋                                ╋╋╋╋                           ╋╋╋             ╋╋╋                       
 ╋                                                        ╋           ╋╋╋                  ╋╋╋╋                               ╋╋╋╋                            ╋╋╋             ╋╋╋                       
 ╋                                                        ╋          ╋╋╋                    ╋╋╋╋                              ╋╋╋╋                            ╋╋╋             ╋╋╋                       
 ╋                                                        ╋        ╋╋╋╋       ╋╋╋╋╋╋╋╋╋╋    ╋╋╋╋                             ╋╋╋╋                             ╋╋╋             ╋╋╋                       
 ╋                                                        ╋       ╋╋╋╋       ╋╋╋     ╋╋╋     ╋╋╋╋                           ╋╋╋╋                              ╋╋╋             ╋╋╋                       
 ╋                                                        ╋      ╋╋╋╋      ╋╋╋╋       ╋╋╋    ╋╋╋╋╋                          ╋╋╋╋                              ╋╋╋             ╋╋╋                       
 ╋                                                        ╋     ╋╋╋       ╋╋╋╋         ╋╋╋    ╋╋╋╋                         ╋╋╋╋                               ╋╋╋             ╋╋╋                       
 ╋                                                        ╋    ╋╋╋       ╋╋╋╋          ╋╋╋     ╋╋╋╋                        ╋╋╋╋                      ╋╋╋╋╋╋╋╋╋╋╋╋             ╋╋╋                       
 ╋                                                        ╋  ╋╋╋╋       ╋╋╋             ╋╋╋    ╋╋╋╋                       ╋╋╋╋               ╋╋╋╋╋╋╋╋╋╋╋╋╋╋╋╋╋╋╋╋             ╋╋╋                       
 ╋                                                        ╋ ╋╋╋╋      ╋╋╋╋               ╋╋╋    ╋╋╋╋                      ╋╋╋╋        ╋╋╋╋╋╋╋╋╋╋╋╋╋╋╋╋╋╋╋╋╋╋╋╋╋╋╋             ╋╋╋                       
 ╋                                                        ╋╋╋╋╋      ╋╋╋╋                ╋╋╋    ╋╋╋╋╋                    ╋╋╋╋╋╋╋╋╋╋╋╋╋╋╋╋╋╋╋╋╋╋╋╋╋╋╋╋                         ╋╋╋                       
 ╋                                                        ╋╋╋       ╋╋╋╋                  ╋╋╋    ╋╋╋╋                    ╋╋╋╋╋╋╋╋╋╋╋╋╋╋╋╋╋╋╋╋                                 ╋╋╋                       
 ╋                                                       ╋╋╋       ╋╋╋                     ╋╋╋    ╋╋╋╋╋╋╋╋╋╋╋╋╋╋╋╋╋╋╋╋╋╋╋╋╋╋╋╋╋╋╋╋╋╋╋╋╋                                       ╋╋╋                       
 ╋                                                       ╋╋      ╋╋╋╋                      ╋╋╋    ╋╋╋╋╋╋╋╋╋╋╋╋╋╋╋╋╋╋╋╋╋╋╋╋╋╋╋╋                                                ╋╋╋                       
 ╋                                                              ╋╋╋                         ╋╋╋    ╋╋╋╋╋╋╋╋╋╋╋╋╋╋╋╋╋╋╋╋╋╋╋╋╋╋                                                 ╋╋╋                       
 ╋                                                            ╋╋╋╋                           ╋╋╋    ╋╋╋╋╋╋╋╋╋╋╋╋╋╋╋╋╋╋╋╋╋                                                     ╋╋╋                       
 ╋                                                           ╋╋╋╋                            ╋╋╋                                            ╋╋╋╋╋╋╋╋╋╋╋╋╋╋╋╋╋╋╋╋╋             ╋╋╋                       
 ╋                                                          ╋╋╋╋                              ╋╋╋                                   ╋╋╋╋╋╋╋╋╋╋╋╋╋╋╋╋╋╋╋╋╋╋╋╋╋╋╋╋╋╋            ╋╋╋                       
 ╋                                                         ╋╋╋                                 ╋╋╋                          ╋╋╋╋╋╋╋╋╋╋╋╋╋╋╋╋╋╋╋╋╋╋╋╋╋╋╋╋╋╋╋╋╋╋╋╋╋╋            ╋╋╋                       
 ╋                                                        ╋╋╋                                  ╋╋╋               ╋╋╋╋╋╋╋╋╋╋╋╋╋╋╋╋╋╋╋╋╋╋╋╋╋╋╋╋╋╋╋╋╋╋╋╋╋╋        ╋╋╋            ╋╋                        
 ╋                                                        ╋                                     ╋╋╋ ╋╋╋╋╋╋╋╋╋╋╋╋╋╋╋╋╋╋╋╋╋╋╋╋╋╋╋╋╋╋╋╋╋╋╋╋╋╋                     ╋╋╋           ╋╋╋                        
 ╋                                                        ╋                                      ╋╋╋╋╋╋╋╋╋╋╋╋╋╋╋╋╋╋╋╋╋╋╋╋╋╋╋╋                                   ╋╋╋         ╋╋╋                         
 ╋                                                        ╋                                      ╋╋╋╋╋╋╋╋╋╋╋╋╋╋╋╋                                               ╋╋╋╋       ╋╋╋╋                         
 ╋                                                        ╋                                       ╋╋                                                             ╋╋╋╋╋  ╋╋╋╋╋╋                          
 ╋╋╋╋╋╋╋╋╋╋╋╋╋╋╋╋╋╋╋╋╋╋╋╋╋╋╋╋╋╋╋╋╋╋╋╋╋╋╋╋╋╋╋╋╋╋╋╋╋╋╋╋╋╋╋╋╋╋                                                                                                        ╋╋╋╋╋╋╋╋╋                            
                                                                                                                                                                    ╋╋╋╋╋╋╋                             
                                                                                                                                                                                                        
                                                                                                                                                                                                        
                                                                                                                                                                                                        
                                                                                                                                                                                                        
                                                                                                                                                                                                        
                                                                                                                                                                                                        
                                                                                                                                                                                                        
                                                                                                                                                                                                        
                                                                                                                                                                                                        
                                                                                                                                                                                                        
                                                                                                                                                                                                        
                                                                                                                                                                                                        
                                                                                                                                                                                                        
