┃┃┃┃┃┃┃┃┃┃┃┃┃┃┃┃┃┃┃┃┃┃┃┃┃┃┃┃┃┃┃┃┃┃┃┃┃┃┃┃┃┃┃┃┃┃┃┃........................................................................................................┃┃┃┃┃┃┃┃┃┃┃┃┃┃┃┃┃┃┃┃┃┃┃┃┃┃┃.....................
┃...........................................┃┃┃┃........................................................................................................┃┃┃......................┃┃┃....................
┃...........................................┃┃┃┃........................................................................................................┃┃┃......................┃┃┃....................
┃...........................................┃┃┃┃┃┃┃┃┃┃┃┃┃┃┃┃┃┃┃┃┃┃┃┃┃┃┃┃┃┃┃┃┃┃┃┃┃┃┃┃┃...................................................................┃┃┃......................┃┃┃....................
┃...........................................┃┃┃┃┃┃┃┃┃┃┃┃┃┃┃┃┃┃┃┃┃┃┃┃┃┃┃┃┃┃┃┃┃┃┃┃┃┃┃┃┃┃...................................................................┃┃┃....................┃┃┃.....................
┃............................................┃┃┃┃┃┃┃┃┃┃┃┃┃┃┃┃┃┃┃┃┃┃┃┃┃┃┃┃┃┃┃┃┃┃┃┃┃┃┃┃┃┃..................................................................┃┃┃....................┃┃┃.....................
┃............................................┃┃┃┃┃┃┃┃┃┃┃┃┃┃┃┃┃┃┃┃┃┃┃┃┃┃┃┃┃┃┃┃┃┃┃┃┃┃┃┃┃┃┃┃┃┃┃┃┃┃┃.........................................................┃┃┃....................┃┃┃.....................
┃...................................................................................┃┃┃┃┃┃┃┃┃┃┃┃┃┃.......................................................┃┃┃....................┃┃┃.....................
┃...................................................................................┃┃┃┃┃┃┃┃┃┃┃┃┃┃┃┃┃.....................................................┃┃┃...................┃┃┃.....................
┃...................................................................................┃┃┃┃┃┃┃┃┃┃┃┃┃┃┃┃┃┃┃...................................................┃┃┃...................┃┃┃.....................
┃┃┃┃┃┃┃┃┃┃┃┃┃┃┃┃┃┃┃┃┃┃┃┃┃┃┃┃┃┃┃┃┃┃┃┃┃┃┃┃...........................................┃┃┃┃┃┃┃....┃┃┃┃┃┃┃┃┃┃..................................................┃┃┃...................┃┃┃.....................
┃┃┃┃┃┃┃┃┃┃┃┃┃┃┃┃┃┃┃┃┃┃┃┃┃┃┃┃┃┃┃┃┃┃┃┃┃┃┃┃┃...........................................┃..............┃┃┃┃┃┃┃................................................┃┃┃..................┃┃┃......................
┃┃┃┃┃┃┃┃┃┃┃┃┃┃┃┃┃┃┃┃┃┃┃┃┃┃┃┃┃┃┃┃┃┃┃┃┃┃┃┃┃............................................................┃┃┃┃┃┃...............................................┃┃┃..................┃┃┃......................
┃┃┃┃┃┃┃┃┃┃┃┃┃┃┃┃┃┃┃┃┃┃┃┃┃┃┃┃┃┃┃┃┃┃┃┃┃┃┃┃┃..............................................................┃┃┃┃┃...............................................┃┃┃.................┃┃┃......................
.....................................┃┃┃┃...................................┃...........................┃┃┃┃┃..............................................┃┃┃.................┃┃┃......................
.....................................┃┃┃┃..................................┃┃............................┃┃┃┃┃.............................................┃┃┃.................┃┃┃......................
.....................................┃┃┃┃┃┃┃┃┃┃┃┃┃┃┃┃┃┃┃┃┃┃┃┃┃┃┃┃┃┃┃┃┃┃┃┃┃┃┃┃.............................┃┃┃┃┃............................................┃┃┃.................┃┃┃......................
......................................┃┃┃┃┃┃┃┃┃┃┃┃┃┃┃┃┃┃┃┃┃┃┃┃┃┃┃┃┃┃┃┃┃┃┃┃┃┃...............................┃┃┃┃┃............................................┃┃┃...............┃┃┃.......................
.......................................┃┃┃┃┃┃┃┃┃┃┃┃┃┃┃┃┃┃┃┃┃┃┃┃┃┃┃┃┃┃┃┃┃┃┃┃.................................┃┃┃┃............................................┃┃┃...............┃┃┃.......................
........................................┃┃┃┃┃┃┃┃┃┃┃┃┃┃┃┃┃┃┃┃┃┃┃┃┃┃┃┃┃┃┃┃┃┃...................................┃┃┃┃...........................................┃┃┃...............┃┃┃.......................
......................................................................┃┃┃┃...................................┃┃┃┃...........................................┃┃┃...............┃┃┃.......................
.....................................................................┃┃┃┃.....................................┃┃┃┃...........................................┃┃┃..............┃┃┃.......................
.....................................................................┃┃┃┃.....................................┃┃┃┃...........................................┃┃┃..............┃┃┃.......................
.....................................................................┃┃┃.......................................┃┃┃┃..........................................┃┃┃..............┃┃┃.......................
....................................................................┃┃┃┃.......................................┃┃┃┃..........................................┃┃┃.............┃┃┃........................
....................................................................┃┃┃┃.......................................┃┃┃┃..........................................┃┃┃.............┃┃┃........................
....................................................................┃┃┃┃.......................................┃┃┃┃...........................................┃┃┃............┃┃┃........................
....................................................................┃┃┃.........................................┃┃┃...........................................┃┃┃............┃┃┃........................
....................................................................┃┃┃.........................................┃┃┃...........................................┃┃┃............┃┃┃........................
....................................................................┃┃┃.........................................┃┃┃...........................................┃┃┃............┃┃┃........................
....................................................................┃┃┃.........................................┃┃┃............................................┃┃┃...........┃┃┃........................
....................................................................┃┃┃┃.......................................┃┃┃┃............................................┃┃┃..........┃┃┃.........................
....................................................................┃┃┃┃.......................................┃┃┃┃............................................┃┃┃..........┃┃┃.........................
....................................................................┃┃┃┃.......................................┃┃┃┃............................................┃┃┃..........┃┃┃.........................
....................................................................┃┃┃........................................┃┃┃..............................................┃┃┃.........┃┃┃.........................
....................................................................┃┃┃┃......................................┃┃┃┃..............................................┃┃┃.........┃┃┃.........................
..................................................................┃┃┃┃┃┃......................................┃┃┃┃..............................................┃┃┃.........┃┃┃.........................
................................................................┃┃┃┃┃┃.......................................┃┃┃┃...............................................┃┃┃........┃┃┃..........................
...............................................................┃┃┃┃┃┃........................................┃┃┃┃...............................................┃┃┃........┃┃┃..........................
.............................................................┃┃┃┃┃┃......┃..................................┃┃┃┃.................................................┃┃┃.......┃┃┃..........................
...........................................................┃┃┃┃┃┃┃....┃┃┃┃┃┃...............................┃┃┃┃┃┃┃┃┃┃┃┃┃┃........................................┃┃┃.......┃┃┃..........................
.........................................................┃┃┃┃┃┃┃.....┃┃┃┃┃┃┃┃...........................┃.┃┃┃┃┃┃┃┃┃┃┃┃┃┃┃┃.......................................┃┃┃.......┃┃┃..........................
........................................................┃┃┃┃┃┃......┃┃┃┃┃┃┃┃┃┃.........................┃┃┃┃┃┃┃┃┃┃┃┃┃┃┃┃┃┃┃┃......................................┃┃┃.......┃┃┃..........................
......................................................┃┃┃┃┃┃......┃┃┃┃┃...┃┃┃┃┃.........................┃┃┃┃┃┃┃┃┃┃┃┃┃┃┃┃┃┃┃┃......................................┃┃┃......┃┃┃..........................
....................................................┃┃┃┃┃┃......┃┃┃┃┃┃.....┃┃┃┃┃.........................┃┃.............┃┃┃┃┃.....................................┃┃┃.....┃┃┃...........................
..................................................┃┃┃┃┃┃......┃┃┃┃┃┃........┃┃┃┃┃┃.................┃......┃..............┃┃┃┃.....................................┃┃┃.....┃┃┃...........................
.................................................┃┃┃┃┃......┃┃┃┃┃┃...........┃┃┃┃┃┃┃..............┃┃┃.....................┃┃┃┃....................................┃┃┃.....┃┃┃...........................
...............................................┃┃┃┃┃......┃┃┃┃┃┃...............┃┃┃┃┃┃┃┃┃┃....┃┃┃┃┃┃.......................┃┃┃┃.....................................┃┃┃....┃┃┃...........................
.............................................┃┃┃┃┃......┃┃┃┃┃┃..................┃┃┃┃┃┃┃┃┃┃┃┃┃┃┃┃┃┃┃........................┃┃┃┃....................................┃┃┃....┃┃┃...........................
...........................................┃┃┃┃┃┃.....┃┃┃┃┃┃......................┃┃┃┃┃┃┃┃┃┃┃┃┃┃┃┃.........................┃┃┃┃....................................┃┃┃....┃┃┃...........................
..........................................┃┃┃┃┃.....┃┃┃┃┃┃...........................┃┃┃┃┃┃┃┃┃┃┃┃┃..........................┃┃┃┃.................................┃┃┃┃.....┃┃┃┃..........................
........................................┃┃┃┃┃.....┃┃┃┃┃┃.....................................┃┃┃┃...........................┃┃┃┃┃...............................┃┃┃┃┃.....┃┃┃┃┃.........................
......................................┃┃┃┃┃.....┃┃┃┃┃┃......................................┃┃┃┃.............................┃┃┃┃...............................┃┃┃.........┃┃┃.........................
....................................┃┃┃┃┃┃....┃┃┃┃┃┃............................┃┃┃.........┃┃┃┃..............................┃┃┃┃.............................┃┃┃...........┃┃┃........................
...................................┃┃┃┃┃....┃┃┃┃┃┃.............................┃┃┃┃┃.......┃┃┃┃...............................┃┃┃┃.............................┃┃............┃┃┃........................
.................................┃┃┃┃┃....┃┃┃┃┃┃..............................┃┃┃┃┃┃┃┃....┃┃┃┃.................................┃┃┃┃...........................┃┃┃.............┃┃┃.......................
...............................┃┃┃┃┃.....┃┃┃┃┃...............................┃┃┃┃..┃┃┃┃┃..┃┃┃┃.................................┃┃┃┃...........................┃┃┃.............┃┃┃.......................
.............................┃┃┃┃┃┃....┃┃┃┃┃................................┃┃┃.....┃┃┃┃┃┃┃┃┃...................................┃┃┃┃..........................┃┃┃.............┃┃┃.......................
............................┃┃┃┃┃....┃┃┃┃┃.................................┃┃┃........┃┃┃┃┃┃┃...................................┃┃┃┃..........................┃┃┃.............┃┃┃.......................
..........................┃┃┃┃┃....┃┃┃┃┃┃................................┃┃┃┃...........┃┃┃┃┃...................................┃┃┃┃..........................┃┃┃.............┃┃┃.......................
.┃┃┃┃┃┃┃┃┃┃┃┃┃┃┃┃┃┃┃┃┃┃┃┃┃┃┃┃┃.....┃┃┃┃┃┃┃┃┃┃┃┃┃┃┃┃┃┃┃┃┃┃┃┃.............┃┃┃┃.............┃┃┃┃┃.................................┃┃┃┃...........................┃┃┃.............┃┃┃.......................
.┃.........................┃........┃.....................┃............┃┃┃┃...............┃┃┃┃┃................................┃┃┃┃...........................┃┃┃.............┃┃┃.......................
.┃........................................................┃...........┃┃┃..................┃┃┃┃...............................┃┃┃┃............................┃┃┃.............┃┃┃.......................
.┃........................................................┃..........┃┃┃....................┃┃┃┃..............................┃┃┃┃............................┃┃┃.............┃┃┃.......................
.┃........................................................┃........┃┃┃┃.......┃┃┃┃┃┃┃┃┃┃....┃┃┃┃.............................┃┃┃┃.............................┃┃┃.............┃┃┃.......................
.┃........................................................┃.......┃┃┃┃.......┃┃┃.....┃┃┃.....┃┃┃┃...........................┃┃┃┃..............................┃┃┃.............┃┃┃.......................
.┃........................................................┃......┃┃┃┃......┃┃┃┃.......┃┃┃....┃┃┃┃┃..........................┃┃┃┃..............................┃┃┃.............┃┃┃.......................
.┃........................................................┃.....┃┃┃.......┃┃┃┃.........┃┃┃....┃┃┃┃.........................┃┃┃┃...............................┃┃┃.............┃┃┃.......................
.┃........................................................┃....┃┃┃.......┃┃┃┃..........┃┃┃.....┃┃┃┃........................┃┃┃┃......................┃┃┃┃┃┃┃┃┃┃┃┃.............┃┃┃.......................
.┃........................................................┃..┃┃┃┃.......┃┃┃.............┃┃┃....┃┃┃┃.......................┃┃┃┃...............┃┃┃┃┃┃┃┃┃┃┃┃┃┃┃┃┃┃┃┃.............┃┃┃.......................
.┃........................................................┃.┃┃┃┃......┃┃┃┃...............┃┃┃....┃┃┃┃......................┃┃┃┃........┃┃┃┃┃┃┃┃┃┃┃┃┃┃┃┃┃┃┃┃┃┃┃┃┃┃┃.............┃┃┃.......................
.┃........................................................┃┃┃┃┃......┃┃┃┃................┃┃┃....┃┃┃┃┃....................┃┃┃┃┃┃┃┃┃┃┃┃┃┃┃┃┃┃┃┃┃┃┃┃┃┃┃┃.........................┃┃┃.......................
.┃........................................................┃┃┃.......┃┃┃┃..................┃┃┃....┃┃┃┃....................┃┃┃┃┃┃┃┃┃┃┃┃┃┃┃┃┃┃┃┃.................................┃┃┃.......................
.┃.......................................................┃┃┃.......┃┃┃.....................┃┃┃....┃┃┃┃┃┃┃┃┃┃┃┃┃┃┃┃┃┃┃┃┃┃┃┃┃┃┃┃┃┃┃┃┃┃┃┃┃.......................................┃┃┃.......................
.┃.......................................................┃┃......┃┃┃┃......................┃┃┃....┃┃┃┃┃┃┃┃┃┃┃┃┃┃┃┃┃┃┃┃┃┃┃┃┃┃┃┃................................................┃┃┃.......................
.┃..............................................................┃┃┃.........................┃┃┃....┃┃┃┃┃┃┃┃┃┃┃┃┃┃┃┃┃┃┃┃┃┃┃┃┃┃.................................................┃┃┃.......................
.┃............................................................┃┃┃┃...........................┃┃┃....┃┃┃┃┃┃┃┃┃┃┃┃┃┃┃┃┃┃┃┃┃.....................................................┃┃┃.......................
.┃...........................................................┃┃┃┃............................┃┃┃............................................┃┃┃┃┃┃┃┃┃┃┃┃┃┃┃┃┃┃┃┃┃.............┃┃┃.......................
.┃..........................................................┃┃┃┃..............................┃┃┃...................................┃┃┃┃┃┃┃┃┃┃┃┃┃┃┃┃┃┃┃┃┃┃┃┃┃┃┃┃┃┃............┃┃┃.......................
.┃.........................................................┃┃┃.................................┃┃┃..........................┃┃┃┃┃┃┃┃┃┃┃┃┃┃┃┃┃┃┃┃┃┃┃┃┃┃┃┃┃┃┃┃┃┃┃┃┃┃............┃┃┃.......................
.┃........................................................┃┃┃..................................┃┃┃...............┃┃┃┃┃┃┃┃┃┃┃┃┃┃┃┃┃┃┃┃┃┃┃┃┃┃┃┃┃┃┃┃┃┃┃┃┃┃........┃┃┃............┃┃........................
.┃........................................................┃.....................................┃┃┃.┃┃┃┃┃┃┃┃┃┃┃┃┃┃┃┃┃┃┃┃┃┃┃┃┃┃┃┃┃┃┃┃┃┃┃┃┃┃.....................┃┃┃...........┃┃┃........................
.┃........................................................┃......................................┃┃┃┃┃┃┃┃┃┃┃┃┃┃┃┃┃┃┃┃┃┃┃┃┃┃┃┃...................................┃┃┃.........┃┃┃.........................
.┃........................................................┃......................................┃┃┃┃┃┃┃┃┃┃┃┃┃┃┃┃...............................................┃┃┃┃.......┃┃┃┃.........................
.┃........................................................┃.......................................┃┃.............................................................┃┃┃┃┃..┃┃┃┃┃┃..........................
.┃┃┃┃┃┃┃┃┃┃┃┃┃┃┃┃┃┃┃┃┃┃┃┃┃┃┃┃┃┃┃┃┃┃┃┃┃┃┃┃┃┃┃┃┃┃┃┃┃┃┃┃┃┃┃┃┃┃........................................................................................................┃┃┃┃┃┃┃┃┃............................
....................................................................................................................................................................┃┃┃┃┃┃┃.............................
........................................................................................................................................................................................................
........................................................................................................................................................................................................
........................................................................................................................................................................................................
........................................................................................................................................................................................................
........................................................................................................................................................................................................
........................................................................................................................................................................................................
........................................................................................................................................................................................................
........................................................................................................................................................................................................
........................................................................................................................................................................................................
........................................................................................................................................................................................................
........................................................................................................................................................................................................
........................................................................................................................................................................................................
........................................................................................................................................................................................................
