┏━━━━━━━━━━━━━━━━━━━━━━━━━━━━━━━━━━━━━━━━━━━━━━━━━━━━━━━━━━━━━━━━━━━━━━━━━━┳━━━━━━━━━━━━━━━━━━━━━━━━━━━━━━━━━━━━━━━┓
┃..........................................................................┃.......................................┃
┃..........▣...............................................................┃.......................................┃
┣━━━.━━━━━━━━━━━━━━━━━━┓...........................................................................................┃
┃......................┃...................................................┃.......................................┃
┃......................┃...................................................┃.......................................┃
┃......................┃...................................................┃.......................................┃
┃......................┗━━━━━━━━━━━━━━━━━━━━━━━━━━━━━━━━━━━━━━━━━━━━━━━━━━━┫.......................................┃
┃.............................♥..................♥.........................┃.......................................┃
┃......................┏━━━━━━━━━━━┓...┏━━━━━━━━━━━━━━━━━━━━━━━━━━━━━━━┓...┃.......................................┃
┃......................┃...........┃...┃...............................┃...┃.......................................┃
┃......................┃...........┃...┃.........♥.....................┃...┃.......................................┃
┃......................┃...........┃...┃...............................┃...┃.......................................┃
┃......................┃...........┃...┃...............................┃...┃.......................................┃
┃......................┃...........┃...┃...............................┃...┃.......................................┃
┣━━━━━━━━━━━━━━━━━━━━━━┛...........┃...┗━━━━━━━━━━━━━━━━━━━━━━━━.━━━━━━┛...┃.......................................┃
┃......................♥...........................................................................................┃
┃..................................┃...┏━━━━━━━━━━━━━━━━━━━━━━━━━━━━━━━━━━━━━━━━━━━━━━━━...........................┃
┃..................................┃...┃...........................................................................┃
┣━━━━━━━━━━━━━━━━━━━━━━┓...........┃...┃...........................................................................┃
┃......................┃...........┃...┃...........................................................................┃
┃.............♥........┗━━━━━━━━━━━┛...┗━━━━━━━━━━━━━━━━━━┓........................................................┃
┃.........................................................┃........................................................┃
┃......................┏━━━━━━━━━━━┓......................┃........................................................┃
┃......................┃........♥..┃......................┃........................................................┃
┃......................┃...........┃......................┃........................................................┃
┃......................┃...........┃......................┃........................................................┃
┣━━━━━━━━━━━━━━━━━━━━━━┻━.━━━━━━━━━╋━━━┓..................┃........................................................┃
┃..................................┃......................┃........................................................┃
┃.........................................................┃........................................................┃
┃......................┏━━━━━━━━━━━┓......................┃........................................................┃
┃......................┃♥..........┃......................┃........................................................┃
┃......................┃...........┃......................┃........................................................┃
┃......................┃...........┃......................┃........................................................┃
┃......................┃...........┃......................┃........................................................┃
┃......................┃...........┃......................┃........................................................┃
┃......................┃...........┃...............♥......┃........................................................┃
┃......................┃..................................┃........................................................┃
┃......................┃...........┃......................┃........................................................┃
┃......................┃...........┃......................┃........................................................┃
┃....♥.................┃...........┃......................┃........................................................┃
┃......................┃...........┃......................┃........................................................┃
┃......................┃...........┃......................┃......................................................♥.┃
┃......................┃...........┃......................┃........................................................┃
┗━━━━━━━━━━━━━━━━━━━━━━━━━━━━━━━━━━━━━━━━━━━━━━━━━━━━━━━━━━━━━━━━━━━━━━━━━━━━━━━━━━━━━━━━━━━━━━━━━━━━━━━━━━━━━━━━━━┛
